NO ./textures/Wall_N.xpm
SO ./textures/Wall_S.xpm
EA ./textures/Wall_E.xpm                  
WE ./textures/Wall_W.xpm

F 0,220,0
C 225,30,0

        1111111111111111111111111
        1000000000110000000011111
        1011000001110000000000001
        1101000000000000000000001
111111111011000001110000000000001
100000000110000011101111111111111 
11110111111111011100000010001      
11110111111111011101010010001
10000000110101011100000010001
11111111110000000000010001101
10000000000000000000000S00001
10000000110000001000000000001
11010111 1110101 101111010001








    